UUUUUUUU
L------R
L------R
L------R
L------R
L------R
L------R
L------R
L------R
DDDDDDDD
